NO ./images/north_side.xpm
WE ./images/west_side.xpm
SO ./images/south_side.xpm
EA ./images/east_side.xpm
F 225, 100, 236
C 135, 206, 250

11111111111111111111
10000000000000000001
10000000000000010001
10001000000000000001
10000000000100000001
100010000W0000000111
10000000000000000001
10000001000100000001
10000000000000000001
11111111111111111111
