NO textures/wall_00.xpm
SO textures/wall_01.xpm
WE textures/wall_02.xpm
EA textures/wall_03.xpm
F 220,100,236
C 225,30,2
1111111111111111111111111
1N00000000110000000000001
1011000001110000000000001
1001000000000000000000001
1111111111111111111111111
